03244230
03244230
03222230
03555530
03000030
03011000
00011030
03000030
03222230
03244230
03244230