03455430
03455430
03444430
03222230
03000030
00011000
03000030
03222230
03444430
03455430
03455430